XXXXXXXXXXXXXXXX
XIIIIIIIIIIIIIIX
XIIIIIII@IIIIIIX
XIIIIIIIIIIIIIIX
XIII@IIIIIIIII@X
XIIIIIIIIIIIIIIX
XIIIIIII$IIIIIII
XI{IIIII$IIIIIII
XIIIIIIIIIIIIIIX
XIII@IIIIIIIII@X
XIIIIIIIIIIIIIIX
XIIIIIII@IIIIIIX
XIIIIIIIIIIIIIIX
XXXXXXXXXXXXXXXX