XXXXXXXXXXXXXXXX
XIIIIIIIIIIIIIIX
XIIIIIIIIIII!IIX
XIITIIIIIIIITIIX
XIII#IIIIIIIIIIX
XIIIIIIIIIIIIIIX
XIIIIIIIIIIIIBII
XIIIIIBIIIIIIBII
XIIIIIIIIIIIIBBX
XIIIII!IIIIIIIIX
XIITIIIIIIIITIIX
XIIIIIIIIIIIIIIX
XIIIIIIIIIIIIIIX
XXXXXXXIIXXXXXXX