BBBBBBRRRLLLLRRR
BLLLLBLLLLLLLLLR
BLL*LBLLLLLLLLLR
BLLLLBLLLLLLLLLR
BBBBBBLLLLLLLLLR
BBBBBBLLLLLLLLLL
BBB3BBLLLLLLLLLL
RLLLLLLLLLLLLLLL
RLLLLLLLLLLLLLLL
RLLLLLLLLLLLLLLR
RLLLLLLLLLLLLLLR
RLLLLLLLLLLLLLLR
RLLLLLLLLLLLLLLR
RRRRRRRRRRRRRRRR