XXXXXXXIIXXXXXXX
XII%IIIIIIII%IIX
XIITIIIIIIIITIIX
XIIITII###ITIIIX
XIIIITIIIITIIIIX
XII@IITIITII@IIX
IIIIIII$$IIIIIIX
IIIIIITIITIIIIIX
XII@ITIIIITI@IIX
XIIITIIIIIITIIIX
XIITIII###IITIIX
XIIIIIIIIIIIIIIX
XIII%IIIIIII%IIX
XXXXXXXIIXXXXXXX