RRRRRRLLLLAAAARR
RLLLLLLLLLAAAALR
RLDL&LLLLAAAALLR
RLLLLLLLAAAALLLR
RLLLLLLAAAALULLR
LLLLLLAAAALLL^LR
LLLLLLGGGGLLLLLR
LLLLLLGGGGLLLLLR
LLLLLLAAAALLLLLR
RLLLLLAAAALLLLLR
RL&LLLAAAALLLLLR
RLLLLLAAAALL&LLR
RLLLLLAAAALLLLLR
RRRRRRAAAARRRRRR