XXXXXXXXXXXXXXXX
XIIIIIIIIIIIIIIX
XIIIIIIIIIIIIIIX
XIITI$II$II$TIIX
XIIIIIIIIIIIIIIX
XIIIIIIIIIIIIIIX
IIIIIIIIIIIIIIII
IIIIIIIIIIIIIIII
XIIIIIIIIIIIIIIX
XI@IIIIIIIIIIIIX
XIITI$II$II$TIIX
XIIIIIIIIIIIIIIX
XIIIIIIIIIIIIIIX
XXXXXXXXXXXXXXXX