RRRRRRLLLLRRRRRR
RLLLLLLLLLLLLLLR
RLLDLLLLLLLLDLLR
RLLLLLLLLLLLLLLR
RLLLLLLLLLLLLLLR
LLLLLLLLLLLLLLLL
LLLLLLLLL^LLLLLL
LLLLLLLLLLLLLLLL
LLLLLLLLLLLLLLLL
RLLLLLLLLLLLHLLR
RLLLLLLLLLLLLLLR
RLLHLLLLLLLL&LLR
RLLLLLLLLLLLLLLR
RRRRRRLLLLRRRRRR