RRRRRRLLLLRRRRRR
RLLLLLLLLLLLLLLR
RLL&LLLLLLLLLHLR
RLLLLLLLLLLLLLLR
RLLLLLLLLL^LLLLR
LLLLLLFFFFLLLLLL
LLLLLLFFFFLLLLLL
LLLLLLFFFFLLLLLL
LLLLLLFFFFLLLLLL
RLLLLLLLLL^LLLLR
RLLLLLLLLLLLLLLR
RLLHLLLLLLLLHLLR
RLLLLLLLLLLLLLLR
RRRRRRRRRRRRRRRR