XXXXXXXXXXXXXXXX
XIIIIIIIIIIIIIIX
XIIIIIIIIIIIIIIX
XIITIII#IIIITIIX
XIIIIIIIIIIIIIIX
XIIIIIIII!IIIIIX
IIIIIIIIIIIIIIIX
IIIIIIIIIIIIIIIX
XI!IIIIIIIIIIIIX
XIIIIIII%IIIIIIX
XIITIIII#IIITIIX
XIIIIIIIIIIIIIIX
XIIIIIIIIIIIIIIX
XXXXXXXIIXXXXXXX