XXXXXXXIIXXXXXXX
XIIIIIIIIIIIIIIX
XIIIIIIII$IIIIIX
XIITIIIIIIIITIIX
XIII$IIIIIIIIIIX
XIIIIIIIIIIIIIIX
IIIIIIIIIIIIIIIX
IIIIIIIIIIIIIIIX
XIIIIIIIIIIIIIIX
XIIIIIIIII$IIIIX
XIITIIIIIIIITIIX
XII$IIIIIIIIIIIX
XIIIIIIIIIIIIIIX
XXXXXXXIIXXXXXXX