RRRRRRRRRRRRRRRR
RLLLLLLLLLLLLLLR
RLLLLLLLLFFLLLLR
RLLL!LLLLLLLLLLR
RLLLLLLLLLLLLLLR
RLLFFFLLLLLL!LLR
RLLLLLLL&LLLLLLR
RLLL!LLLLLLLLLLR
RLLLLLLLLLFLLLLR
RLLLLLLLLLLLLLLR
RLLLLLLLLLLL!LLR
RLLFLLLLLLLLLLLR
RLLLLLLLLLFFLLLR
RRRRRRLLLLRRRRRR