RRRRRRLLLLRRRRRR
RLLLLLLLLLLLLLLR
RLLLLL&&&LLLLLLR
RLLLLLLLLLLLLLLR
RLLLLLLLLLLLLLLR
RLLLLLLLLLLL!LLR
RLLLLLL%LLLLLLLR
RLLLLLL%LLLLLLLR
RLLLLLLLLLLL!LLR
RLLL!LLL!LLLLLLR
RLLLLLLLLLLLLLLR
RLLLLLLLL!LLLLLR
RLL!LLLLLLLLLLLR
RRRRRRLLLLRRRRRR