XXXXXXXIIXXXXXXX
XIIIIIIIIIIIIIIX
XIII@IIIIIIIIIIX
XIITIIIIIII@TIIX
XIIIIIIIIIIIIIIX
XIIIIIIII@IIIIIX
XIIIIIIIIIIIIIII
XIIII@IIIIIIIIII
XIIIIIIIIIIIIIIX
XIIIIIIIIIIIIIIX
XI@TIIIIIII@TIIX
XIIIIIIIIIIIIIIX
XIIIIII@IIIIIIIX
XXXXXXXXXXXXXXXX