RRRRRRLLLLRRRRRR
RFFFFLLLLLLFFFFR
RFFFFLLLLLLFFFFR
RFFFFLLLLLLFFFFR
RFFFFLLLLLLFFFFR
LLLLL^LLLL^LLLLL
LLLLLLLLLLLLLLLL
LLLLLLLLLLLLLLLL
LLLLL^LLLL^LLLLL
RFFFFLLLLLLFFFFR
RFFFFLLLLLLFFFFR
RFFFFLLLLLLFFFFR
RFFFFLLLLLLFFFFR
RRRRRRLLLLRRRRRR