RRRRRRLLLLRRRRRR
RLLLLLLLLLLLLLLR
RLLLLLLLLLLL&LLR
RLLLLLLLLLLLLLLR
RLLLLLLLLLLLLLLR
LLLLLLFFFLLLLLLL
LLLLLLFL^FLLLLLL
LLLLLLFFFLLLLLLL
LLLLLLFLLLLLLLLL
RLLLLLLLLLLLLLLR
RLLLLLLLLLLLLLLR
RLLLLLLLLLLLLLLR
RLLLLLLLLLLLLLLR
RRRRRRRRRRRRRRRR