XXXXXXXXXXXXXXXX
XIIIIIIIIIIIIIIX
XII$IIIIIIII$IIX
XIITIII@IIIITIIX
XIIIIIIIIIIIIIIX
XIIIIIIIIIIIIIIX
XIIIIIIIIIIIIIII
XIIIIIIIIIIIIIII
XIIIIIIII@IIIIIX
XIIIIIIIII%IIIIX
XIITI%IIIIIITIIX
XIII@II%IIIIIIIX
XIIIIIIIIII%IIIX
XXXXXXXIIXXXXXXX