XXXXXXXXXXXXXXXX
XIIIIIIIIIIIIIIX
XIIIIIIIIIIIIIIX
XIIIIIIIIIIIIIIX
XIIIIIIIIIIIIIIX
XIIIIAAAAAAAAAAX
XIIIIAIIIIIIIIII
XIIIIAIIIIIIIIII
XIIIIAIIIIAAAAAX
XIIIIAIIIIAIIIIX
XIIIIAIIIIAIIIIX
XIIIIAIIIIAIIIIX
XIIIIAIIIIAIIIIX
XXXXXXIIIIXXXXXX