RRRRRRLLLLRRRRRR
RLLLLLLLLLLLLLLR
RLLLLLLLLLLLLLLR
RLLLLLLLLLLLLLLR
RLLLLLLLLLLLLLLR
LLLLLLFLFLFLLLLL
LLLLLLFLFLFLLLLL
LLLLLLLFLFLLLLLL
LLLLLLLFLFLLLLLL
RLLLLLLLLLLLLLLR
RLLLLLLLLLLLLLLR
RLLLLLLLLLLLLLLR
RLLLLLLLLLLLLLLR
RRRRRRRRRRRRRRRR