XXXXXXXXXXXXXXXX
X@III@III@III@IX
XIIIIIIIIIIIIIIX
XIITIIIIIIIITIIX
XIIIIIIIIIIIIIIX
XIIIIIIIIIIIIIIX
IIIIIIIIIIIIIIIX
IIIIIIIIIIIII}IX
XIIIIIIIIIIIIIIX
XIIIIIIIIIIIIIIX
XIITIIIIIIIITIIX
XIIIIIIIIIIIIIIX
X@III@III@III@IX
XXXXXXXXXXXXXXXX