XXXXXXXXXXXXXXXX
XAAAAAAAAAAAAAAX
XAIII@IIIIIIIIAX
XAITIIIIIIIITIAX
XAIIIIIII#IIIIAX
XAIBII#IIIIIIIAX
IIIBIIIIIIIIIIAX
IIIBIIIIIIIIIIAX
XAIBIIIIIIIIIIAX
XABBBBIIIIIIIIAX
XAITIIIIIIIITIAX
XA@IIIIIIIIIIIAX
XAAAAAAIIAAAAAAX
XXXXXXXIIXXXXXXX