XXXXXXXIIXXXXXXX
XI@I@I@II@I@I@IX
XIIIIIIIIIIIIIIX
XIIAAAAAAAAAAIIX
XIIIIIIIIIIIIIIX
XAAAAAAIIAAAAAAX
XIIIIIIIIIIIIIIX
XIIAAAAAAAAAAIIX
XIIIIIIIIIIIIIIX
XAAAAAAIIAAAAAAX
XIIIIIIIIIIIIIIX
XIIAAAAAAAAAAIIX
XIIIIIIIIIIIIIIX
XXXXXXXIIXXXXXXX