XXXXXXXIIXXXXXXX
X@IIIIIIIIIIII@X
XIIIIIIIIIIIIIIX
XIITIIIIIIIITIIX
XIIIIIIIIIIIIIIX
XIIIIIIIIIIIIIIX
IIIIIIIIIIIIIIIX
IIIIIIIIIIIIIIIX
XIIIIIIIIIIIIIIX
XIIIIIIIIIIIIIIX
XIITIIIIIIIITIIX
XIIIIIIIIIIIIIIX
X@IIIIIIIIIIII@X
XXXXXXXXXXXXXXXX