RRRRRRLLLLWWWWRR
RLLLLLLLLLWWWWLR
RLL^LLLLLLWWWWLR
RLLLLLLLLWWWWLLR
RLLLLLLLWWWWLLLR
LLLLLLLWWWWLLLLL
LLLLLLGGGGLLLLLL
LLLLLLGGGGLLLLLL
LLLLLLWWWWLLLLLL
RLLLLLWWWWLL&LLR
RLLLLLWWWWLLLLLR
RLL^LLWWWWLLLLLR
RLLLLLWWWWLLLLLR
RRRRRRWWWWRRRRRR