XXXXXXXIIXXXXXXX
XIIIII#IIIIIIIIX
XIIBBBBBBBBBBIIX
XIIIIIIIIIIIII%X
XIIBII#IIIIIBIIX
XIIBIIITTIIIBIIX
XIIBIIIIIIIIBIII
XIIBIIIIII#IBIII
XIIBIIITTIIIBIIX
XIIBII#IIIIIBIIX
XIIIIIIIIIIIII%X
XIIBBBBBBBBBBIIX
XIIIIIIIII#IIIIX
XXXXXXXIIXXXXXXX