RRRRRRRRRRRRRRRR
RLLLLLLL&LLLLLLR
RLLLDLLLLLLLDLLR
RLLLLLLULLLLLLLR
RLLLLFFFFFLLLLLR
LLLLLFBBBFLLLLLL
LLLLLFBEBFLLLLLL
LLLLLFBBBFLLLLLL
LLLLLFFFFFLLLLLL
RLLLLLLLLLLLLLLR
RFFFLLLLLLLLFFFR
RF^FLLLLLLLLF^FR
RFFFLLLLLLLLFFFR
RRRRRRLLLLRRRRRR