RRRRRRLLLLRRRRRR
RLLLLLLLLLLLLLLR
RLLLLLLLLLLLLLLR
RLLLLLLLLLLLLLLR
RLLLLLLFFLLLLLLR
LLLLLLFL^FLLLLLL
LLLLLLLFFLLLLLLL
LLLLLLFL^FLLLLLL
LLLLLLLFFLLLLLLL
RLLLLLLLLLLLLLLR
RLLLLLLLLLLLLLLR
RLLLLLLLLLLLL&LR
RLLLLLLLLLLLLLLR
RRRRRRRRRRRRRRRR