XXXXXXXIIXXXXXXX
XIIIIIIIIIIIIIIX
XIIIIIII!IIIIIIX
XIITIIIIIIIITIIX
XIIIIIIIIIIIIIIX
XIIIIIIIIIIIIIIX
XIIIIIIIIIIIIIII
XIIII!IIIIIIIIII
XIIIIIIIIIIIIIIX
XIIIIIIIIIIIIIIX
XIITIIIIII!ITIIX
XIIIIIIIIIIIIIIX
XIIIIIIIIIIIIIIX
XXXXXXXXXXXXXXXX