RRRRRRRRRRRRRRRR
RLLLLLLLLLLLLLLR
RLLLLLLLLLLLLLLR
RLLLLLLLLLLLLLLR
RLLLLFFFFFLLLLLR
RLLLLFBBBFLLLLLL
RLLLLFBEBFLLLLLL
RLLLLFBBBFLLLLLL
RLLLLFFFFFLLLLLL
RLLLLLLLLLLLLLLR
RLLLLLLLLLLLLLLR
RLLLLLLLLLLLLLLR
RLLLLLLLLLLLLLLR
RRRRRRLLLLRRRRRR