RRRRRRLLLLRRRRRR
RLLLLLLLLLLLLLLR
RLLLLLLLLLLLLLLR
RLLLLLLLLL&LLLLR
RLLLLLLLLLLLLLLR
RL#LLLLLLLLLLLLL
RLLLLLLLLLLLLLLL
RLLLLLLLLLLLLLLL
RLLLLLLLLLLLLLLL
RLLLLLLLLLLLLLLR
RLLLLLL^LLLLLLLR
RLLLLLLLLLLLLLLR
RLLLLLLLLLLLLLLR
RRRRRRRRRLLLLRRR