XXXXXXXIIXXXXXXX
XIII%II%II%IIIIX
XIIBBBBBBBBBBIIX
XIIIIIIIIIIIII%X
XIIBIIIIIIIIBIIX
XIIBIIITTIIIBIIX
IIIBIIII@IIIBIIX
IIIBIIII@IIIBIIX
XIIBIIITTIIIBIIX
XIIBIIIIIIIIBIIX
XIIIIIIIIIIIII%X
XIIBBBBBBBBBBIIX
XII%III%IIII%IIX
XXXXXXXIIXXXXXXX