XXXXXXXIIXXXXXXX
X$IIIII%IIIIII$X
XI&IIIII%IIII&IX
XIIIEII$IIIEIIIX
XIIIEII$IIIEIIIX
XIIIEII$IIIEIIIX
IIIIEII$IIIEI@IX
IIIIEII$IIIEI@IX
XIIIEII$IIIEIIIX
XIIIEII$IIIEIIIX
XIIIEII$IIIEIIIX
XI&IIIII%IIII&IX
X$IIIII%IIIIII$X
XXXXXXXXXXXXXXXX