RRRRRAAAARRRRRRR
RLLULAAAALULLLLR
RLLLLAAAALLLLLLR
RLLLLAAAALLL&LLR
RLLLLAAAALLLLLLR
LLLLLAAAALLLLLLR
LLLLLGGGGLLLLLLR
LLLLLGGGGLLLLLLR
LLLLLLAAAALLLLLR
RLLLLLLAAAALL^LR
RLLLLLLLAAAALLLR
RLL&LLLLLAAAALLR
RLLLLLLLLLAAAALR
RRRRRRLLLLAAAARR