XXXXXXXXXXXXXXXX
XIIIIIIIIIIIIIIX
XIIIIIIIIIIIIIIX
XIITIIIIIIIITIIX
XIIIIIIIIIIIIIIX
XIIIIIIIIIIIIIIX
IIIIIIIIIIIIIIII
IIIIIIIIIIIIIIII
XIIIIIIIIIIIIIIX
XIIIIIIIIIIIIIIX
XIITIIIIIIIITIIX
XIIIIIIIIIIIIIIX
XIIIIIIIIIIIIIIX
XXXXXXIIIIXXXXXX