XXXXXXXIIXXXXXXX
XIIIIIIIIIIIIIIX
XIIIII@IIIIIIIIX
XIITIIII%IIITIIX
XIIIIIIIIIIIIIIX
XIIIIIII%IIIIIIX
IIIIIIIIIIIIIIIX
IIIIIIIIIIIIIIIX
XIIIIIIIIIIIIIIX
XIIIIIIIIIIIIIIX
XIITIIIIIIIITIIX
XII@IIIIIIII@IIX
XIIIIIIIIIIIIIIX
XXXXXXXXXXXXXXXX