RRRRRRLLLLRRRRRR
RHHHLLLLLLLLHHHR
RHHHLLLLLLLLHHHR
RHHHLLLLLLLLHHHR
RLLL^LLLLLLL^LLR
LLLLLLLLLLLLLLLL
LLLLLLLLLLLLLLLL
LLLLLLLLLLLLLLLL
LLLLLLLLLLLLLLLL
RLLLLLLLLLLLLLLR
RLLLLLLLLLLLLLLR
RLLLLLLLLLLL&LLR
RLLLLLLLLLLLLLLR
RRRRRRLLLLRRRRRR