RRRRRRLLLLRRRRRR
RLLLLLLLLLLLLLLR
RLLLLLLLLLLL&LLR
RLLLLLLLLLLLLLLR
RLLLLLLLLLLLLLLR
LLLLLLFLLFLLLLLL
LLLLLLFFLFLLLLLL
LLLLLLFLFFLLLLLL
LLLLLLF^LFLLLLLL
RLLLLLLLLLLLLLLR
RLLLLLLLLLLLLLLR
RLLLLLLLLLLLLLLR
RLLLLLLLLLLLLLLR
RRRRRRRRRRRRRRRR