RRRRRRLLLLRRRRRR
RLLLLLLLLLLLLLLR
RLLL&LLLLLLLLLLR
RLLLLLLLLLLLLLLR
RLLLLLLLLLLLLLLR
RLLLLLLLLLLLLLLR
RLLLLLLLLLLLLLLR
RLLLLLLLLLL^LLLR
RLLLLLLLLLLLLLLR
RLLLLLLLLLLLLLLR
RLLLLLLLLLLLLLLR
RLLLLLLLLLLLLLLR
RLLLLLLLLLLLLLLR
RRRRRRLLLLRRRRRR