RRRRRRLLLLRRRRRR
RFFFLLLLLLLLFFFR
RFFF&LLLLLLLFFFR
RFFFLLLLLLLLFFFR
RLLLLLLLLLLLLLLR
LLLLLLLLLLLLLLLL
LLLLLLLLLLLLLLLL
LLLLLLLLLLL^LLLL
LLLLLLLLLLLLLLLL
RLLLLLLLLLLLDLLR
RLLLLLLLLLLLLLLR
RLLLULLLLLLLLLLR
RLLLLLLLLLLLLDLR
RRRRRRLLLLRRRRRR