RRRRRRLLLLRRRRRR
RLLLLLLLLLLLLLLR
RLLL&LLLLLLLLLLR
RLLLLLLLLLLLLLLR
RLLLLLLLLLLLLLLR
LLLLLLLLLLLLLLLL
LLLLLLLLLLLLLLLL
LLLLLLLLLLL^LLLL
LLLLLLLLLLLLLLLL
RLLLLLLLLLLLLLLR
RLLLLLLLLLLLLLLR
RHHLLLLLLLLLLHHR
RHHLLLLLLLLLLHHR
RRRRRRLLLLRRRRRR