RRRRRRLLLLRRRRRR
RLLLLLLLLL&LLLLR
RLLLLLLLLLLLLLLR
RLLLLLLLLLLLLLLR
RLLLLLLLLLLLLLLR
LLLLLLFFFLLLLLLL
LLLLLLFL^FLLLLLL
LLLLLLFFFLLLLLLL
LLLLLLFLLLLLLLLL
RLLLLLLLLLLLLLLR
RLLLLLLLLL^LLLLR
RLLLLLLLLLLLLLLR
RLLLLLLLLLLLLLLR
RRRRRRRRRRRRRRRR