XXXXXXXXXXXXXXXX
XIIIIIIIIIIIIIIX
XIIIIIIIIIIIIIIX
X$$$$$$$$$$$$$$X
XIIIIIIIIIIIIIIX
XIIIIIIIIIIIIIIX
XIIIIIIIIIIIIIII
XIIIIIIIIIIIIIII
XIIIIIIIIIIIIIIX
XIIII%IIIIIIIIIX
XIIIIIIIIII%IIIX
XII%IIIIIIIIIIIX
XIIIIIIIIIIII%IX
XXXXXXXIIXXXXXXX