XXXXXXXIIXXXXXXX
XIIIIIIIIIIIIIIX
XII#IIIIIIIIIIIX
XIITIIII!IIITIIX
XIIIIIIIIIIIIIIX
XIII!IIIIIIIIIIX
XIIIIIIII#IIIIIX
XIIIIIIIIIIII!IX
XI!II#IIIIIIIIIX
XIIIIIIIIIIIIIIX
XIITIII!IIIITIIX
XII#IIIIIII#IIIX
XIIIIIIIIIIIIIIX
XXXXXXXIIXXXXXXX