XXXXXXXXXXXXXXXX
X$$$I$$$I$$I$$$X
XIIIIIIIIIIIIIIX
XIITIIIIIIIITIIX
XIIIIIIIIIIIIIIX
XAAAAAAAAAAAAAAX
IIIIIIIIIIIIIIII
IIIIIIIIIIIIIIII
XAAAAAAAAAAAAAAX
XIIIIIIIIIIIIIIX
XIITIIIIIIIITIIX
XIIIIIIIIIIIIIIX
X$$$I$$$I$$I$$$X
XXXXXXXXXXXXXXXX