XXXXXXXIIXXXXXXX
XIIIIIIIIIII%IIX
XIIII%IIIIIIIIIX
XII%IIIIIIIIIIIX
XIIIIIIII%IIIIIX
XAAAIIIIIII%IIIX
IIIAIII%IIIIIIIX
IIIAIII%IIIIIIIX
XIIAIIIIIII%IIIX
XIIAIIIIIIIII%IX
XIIAIIIIIIIIIIIX
XIIAIIIIIII%IIIX
XIII%IIIIIIIIIIX
XXXXXXXXXXXXXXXX