RRRRRRWWWWRRRRRR
RLLLLLWWWWLLLLLR
RLL^LLWWWWLLLLLR
RLLLLLWWWWLL^LLR
RLLLLLWWWWLLLLLR
LLLLLLWWWWLLLLLL
LLLLLLGGGGLLLLLL
LLLLLLGGGGLLLLLL
LLLLLLWWWWLLLLLL
RLLLLLLWWWWLLLLR
RLLLLLLLWWWWLLLR
RL&LLLLLLWWWWLLR
RLLLLLLLLLWWWWLR
RRRRRRLLLLWWWWRR