XXXXXXXIIXXXXXXX
XIIIIIIIIIIIIIIX
XIITIIIIIIIITIIX
XIIITIIIIIITIIIX
XIIIITIIIITIIIIX
XII&IITIITII&IIX
XIIIIII$$IIIIIII
XIIIIITIITIIIIII
XII&ITIIIITI&IIX
XIIITIIIIIITIIIX
XIITIIIIIIIITIIX
XIIIIIIIIIIIIIIX
XIIIIIIIIIIIIIIX
XXXXXXXIIXXXXXXX