XXXXXXXIIXXXXXXX
X$IIIIIIIIIIII$X
XI!IIIIIIIIII!IX
XIIIEII@IIIEIIIX
XIIIEIIIIIIEIIIX
XIIIEIIIIIIEIIIX
XIIIEIIIIIIEIIII
XIIIEII$IIIEIIII
XIIIEIIIIIIEIIIX
XIIIEIIIIIIEIIIX
XIIIEII@IIIEIIIX
XI!IIIIIIIIII!IX
X$IIIIIIIIIIII$X
XXXXXXXXXXXXXXXX