RRRRRRLLLLRRRRRR
RFFFLLLLLLLLFFFR
RF^FLLLLLLLLF^FR
RFFFLLLLLLLLFFFR
RLLLLLLLLLLLLLLR
LLLLLL&LFLLLLLLL
LLLLLLLFFLLLLLLL
LLLLLLLLFLLLLLLL
LLLLLLLFFFLLLLLL
RLLLLLLLLLLLLLLR
RLLLLLLLLLLL&LLR
RLLDLLLLLLLLLLLR
RLLLLLLLULLLLLLR
RRRRRRRRRRRRRRRR