XXXXXXXXXXXXXXXX
X$IIIIIIIIIIII$X
XIIBBBIIIIBBBIIX
XIIBIIIIIIIIBIIX
XIIBI%IIII%IBIIX
XIIIIIIIIIIIIIIX
IIIIIIIEEII&IIII
IIIIIIIEEII&IIII
XIIIIIIIIIIIIIIX
XIIBI%IIII%IBIIX
XIIBIIIIIIIIBIIX
XIIBBBIIIIBBBIIX
X$IIIIIIIIIIII$X
XXXXXXXIIXXXXXXX