XXXXXXXIIXXXXXXX
XIIIII%IIIIIIIIX
XIIBBBBBBBBBBIIX
XIIIIIIIIIIIIIIX
XIIBII@IIIIIBIIX
XIIBIIITTIIIBIIX
IIIBIII$$IIIBIII
IIIBIII$$IIIBIII
XIIBIIITTIIIBIIX
XIIBIIIII@IIBIIX
XIIIIIIIIIIIII%X
XIIBBBBBBBBBBIIX
XIIIIIIIII%IIIIX
XXXXXXXIIXXXXXXX