RRRRRRLLLLRRRRRR
RULDLLLLLLLLDLUR
RLLLLLLLLLLLLLLR
RLLLLLLLLL&LLLLR
RLLLLLLFFLLLLLLR
LLLLLLFFFFLLLLLL
LLLLLFFFFFFLLLLL
LLLLLL^FF^LLLLLL
LLLLLLLFFLLLLLLL
RLLLLLLFFLLLLLLR
RHHHLLLLLLLLHHHR
RHHHLLLLLLLLHHHR
RHHHLLLLLLLLHHHR
RRRRRRLLLLRRRRRR